TABLE DIM_CUSTOMERS{
pk_customer_sid	STRING
customer_unique_id	STRING
customer_zip_code_prefix	INTEGER
customer_city	STRING
customer_state	STRING
load_date	STRING
}

TABLE DIM_GEOLOCATION{
geolocation_zip_code_prefix	INTEGER
geolocation_lat	FLOAT
geolocation_lng	FLOAT
geolocation_city	STRING
geolocation_state	STRING
load_date	STRING
}

TABLE DIM_ITEMS{
pk_item_sid	STRING
fk_shipping_limit_date_sid	STRING
order_item_id	INTEGER
product_id	STRING
seller_id	STRING
shipping_limit_date	TIMESTAMP
price	FLOAT
freight_value	FLOAT
product_category_name	STRING
product_category_name_english	STRING
product_name_length	INTEGER
product_description_length	INTEGER
product_photos_qty	INTEGER
product_weight_g	INTEGER
product_length_cm	INTEGER
product_height_cm	INTEGER
product_width_cm	INTEGER
seller_zip_code_prefix	INTEGER
seller_city	STRING
seller_state	STRING
load_date	STRING
}


TABLE DIM_PAYMENTS{
pk_payment_sid	STRING
payment_sequential	INTEGER
payment_type	STRING
payment_installments	INTEGER
payment_value	FLOAT
load_date	STRING
}


TABLE DIM_REVIEWS{
pk_review_sid	STRING
fk_review_creation_date_sid	STRING
review_score	INTEGER
review_comment_title	STRING
review_comment_message	STRING
review_creation_date	TIMESTAMP
review_answer_timestamp	TIMESTAMP
load_date	STRING
}


TABLE FCT_ORDERS{
fk_payment_sid	STRING
fk_review_sid	STRING
fk_item_sid	STRING
fk_customer_sid	STRING
fk_order_purchased_date_sid	STRING
fk_order_approved_at_date_sid	STRING
fk_order_delivered_carrier_date_sid	STRING
fk_order_delivered_customer_date_sid	STRING
fk_order_estimated_delivery_date_sid	STRING
pk_order_id	STRING
order_status	STRING
order_purchase_timestamp	TIMESTAMP
order_approved_at	TIMESTAMP
order_delivered_carrier_date	TIMESTAMP
order_delivered_customer_date	TIMESTAMP
order_estimated_delivery_date	TIMESTAMP
load_date	STRING
 }

TABLE DIM_DATE{
pk_date_sid	STRING
full_date	DATE
year	INTEGER
month	INTEGER
month_name	STRING
day_of_month	INTEGER
day_name	STRING
is_weekday	INTEGER
load_date	STRING
}


Ref: "DIM_ITEMS"."pk_item_sid" < "FCT_ORDERS"."fk_item_sid"

Ref: "DIM_ITEMS"."fk_shipping_limit_date_sid" > "DIM_DATE"."pk_date_sid"

Ref: "FCT_ORDERS"."fk_payment_sid" > "DIM_PAYMENTS"."pk_payment_sid"

Ref: "FCT_ORDERS"."fk_review_sid" > "DIM_REVIEWS"."pk_review_sid"

Ref: "FCT_ORDERS"."fk_customer_sid" > "DIM_CUSTOMERS"."pk_customer_sid"

Ref: "DIM_DATE"."pk_date_sid" < "DIM_REVIEWS"."fk_review_creation_date_sid"

Ref: "DIM_DATE"."pk_date_sid" < "FCT_ORDERS"."fk_order_approved_at_date_sid"

Ref: "DIM_DATE"."pk_date_sid" < "FCT_ORDERS"."fk_order_delivered_carrier_date_sid"

Ref: "DIM_DATE"."pk_date_sid" < "FCT_ORDERS"."fk_order_delivered_customer_date_sid"

Ref: "DIM_DATE"."pk_date_sid" < "FCT_ORDERS"."fk_order_estimated_delivery_date_sid"

Ref: "DIM_DATE"."pk_date_sid" < "FCT_ORDERS"."fk_order_purchased_date_sid"